wwwwwwwwwwwwwwwwwwwwwwwwwwwwwwww
w                              w
w                              w
w                              w
w                              w
w                              w
w               ww          ee w
w                     w     ee w
w    ww               ww       w
w                       w      w
w           w            w     w
w           www          w     w
w                   w    w     w
w                        w     w
w                       ww     w
w  s                   www     w
w              www    wwww     w
wwww        wwwwwwwwwwwwww    ww
