wwwwwwwwwwwwwwwwwwwwwwwwwwwwwwww
w                              w
w                              w
w                              w
w        ww                    w
w       w                      w
w               ww    w     e  w
w                     w        w
w    ww               w        w
w                     www      w
w           w                  w
w           www                w
w           www     w          w
w                        w     w
w                       ww     w
w s             w     wwww     w
w  w      n    www             w
wwwwwwwwwwwwwwwwwwwwwwwwww    ww
